@_author: hardlock
@_date: 2015-02-01 12:54:40
I have just reported licalbitcoins.com  to google. It did not click it but it was easy to click it in search result. (it  has official localbitcoins.com wording in the title).  And I don't see it anymore in search results. 
it looks like possible name variation are taken from this list by 
  
names: 
olcalbitcoins.com	lcoalbitcoins.com	loaclbitcoins.com
loclabitcoins.com	locablitcoins.com	localibtcoins.com
localbticoins.com	localbictoins.com	localbitocins.com
localbitcions.com	localbitconis.com	localbitcoisn.com
localbitcoin.scom	localbitcoinsc.om	localbitcoins.ocm
localbitcoins.cmo	olocalbitcoins.com	lcocalbitcoins.com
loacalbitcoins.com	loclalbitcoins.com	locablbitcoins.com
localibitcoins.com	localbtitcoins.com	localbictcoins.com
localbitocoins.com	localbitcioins.com	localbitconins.com
localbitcoisns.com	localbitcoin.s.com	localbitcoinsc.com
localbitcoins.ocom	localbitcoins.cmom	llocalbitcoins.com
loocalbitcoins.com	loccalbitcoins.com	locaalbitcoins.com
locallbitcoins.com	localbbitcoins.com	localbiitcoins.com
localbittcoins.com	localbitccoins.com	localbitcooins.com
localbitcoiins.com	localbitcoinns.com	localbitcoinss.com
localbitcoins..com	localbitcoins.ccom	localbitcoins.coom
ocalbitcoins.com	kocalbitcoins.com	oocalbitcoins.com
iocalbitcoins.com	1ocalbitcoins.com	pocalbitcoins.com
mocalbitcoins.com	lcalbitcoins.com	licalbitcoins.com
lpcalbitcoins.com	l0calbitcoins.com	l9calbitcoins.com
llcalbitcoins.com	lkcalbitcoins.com	lecalbitcoins.com
loalbitcoins.com	loxalbitcoins.com	lovalbitcoins.com
lodalbitcoins.com	lofalbitcoins.com	
losalbitcoins.com	logalbitcoins.com	loclbitcoins.com
locslbitcoins.com	locqlbitcoins.com	loczlbitcoins.com
locwlbitcoins.com	locxlbitcoins.com	locabitcoins.com
locakbitcoins.com	locaobitcoins.com	locaibitcoins.com
loca1bitcoins.com	locapbitcoins.com	locambitcoins.com
localitcoins.com	localvitcoins.com	localnitcoins.com
localgitcoins.com	localhitcoins.com	localcitcoins.com
localfitcoins.com	localjitcoins.com	localbtcoins.com
localbutcoins.com	localbotcoins.com	localb8tcoins.com
localb9tcoins.com	localbktcoins.com	localbltcoins.com
localb6tcoins.com	localb1tcoins.com	localbjtcoins.com
localbicoins.com	localbircoins.com	localbiycoins.com
localbifcoins.com	localbigcoins.com	localbi5coins.com
localbi6coins.com	localbidcoins.com	localbitoins.com
localbitxoins.com	localbitvoins.com	localbitdoins.com
localbitfoins.com		localbitsoins.com
localbitgoins.com	localbitcins.com	localbitciins.com
localbitcpins.com	localbitc0ins.com	localbitc9ins.com
localbitclins.com	localbitckins.com	localbitceins.com
localbitcons.com	localbitcouns.com	localbitcoons.com
localbitco8ns.com	localbitco9ns.com	localbitcokns.com
localbitcolns.com	localbitco6ns.com	localbitco1ns.com
localbitcojns.com	localbitcois.com	localbitcoims.com
localbitcoibs.com	localbitcoihs.com	localbitcoijs.com
localbitcoius.com	localbitcoin.com	localbitcoina.com
localbitcoind.com	localbitcoinw.com	localbitcoine.com
localbitcoinz.com	localbitcoinx.com	localbitcoinq.com
localbitcoinc.com	localbitcoinscom	
localbitcoins.om	localbitcoins.xom	localbitcoins.vom
localbitcoins.dom	localbitcoins.fom	
localbitcoins.som	localbitcoins.gom	localbitcoins.cm
localbitcoins.cim	localbitcoins.cpm	localbitcoins.c0m
localbitcoins.c9m	localbitcoins.clm	localbitcoins.ckm
localbitcoins.cem	localbitcoins.co
But I can't click to unsafe link from this computer to check. 